40 22
150 100
1 1 1 1 1 1 1 1 1 1 1 1 1 1 1 1 1 1 1 1 1 1 1 1 1 1 1 1 1 1 1 1 1 1 1 1 1 1 1 1 
1 4 4 4 4 4 0 0 0 0 7 0 3 4 0 0 0 0 0 3 0 3 0 0 0 0 0 0 0 4 0 0 0 0 3 0 0 0 0 1 
1 4 4 4 4 4 0 0 0 0 0 4 0 0 0 0 0 0 0 0 0 3 7 0 0 3 0 0 0 0 4 0 0 0 0 0 0 0 0 1 
1 4 4 4 4 4 0 0 0 0 0 4 0 0 4 0 0 0 0 0 3 0 3 0 0 3 0 0 0 0 0 0 0 0 3 0 0 0 0 1 
1 3 0 4 4 0 0 0 0 0 0 0 0 0 3 0 0 0 0 0 0 3 0 0 3 0 0 0 0 3 0 0 0 3 0 0 0 0 0 1 
1 3 0 3 3 0 0 0 0 0 0 0 0 0 3 3 0 0 3 0 0 0 0 0 0 0 0 3 0 0 0 0 0 0 3 0 3 4 0 1 
1 0 0 0 3 0 0 3 0 0 0 0 0 0 0 0 3 0 0 0 0 0 3 0 4 3 0 0 0 0 0 0 0 0 3 0 3 3 0 1 
1 1 1 1 1 1 1 1 1 1 1 1 1 1 1 1 1 1 1 1 1 1 1 1 1 1 1 1 1 1 1 0 0 0 3 0 0 3 0 1 
1 0 4 0 0 0 3 0 0 7 0 4 0 0 3 0 3 0 0 0 0 0 0 0 0 0 0 7 0 3 4 0 0 0 0 0 0 3 0 1 
1 0 0 7 0 0 0 0 0 3 0 0 0 0 0 4 0 0 0 0 0 0 0 0 3 4 4 3 0 0 7 0 0 0 0 3 0 0 0 1 
1 0 0 0 3 0 0 3 0 3 0 0 0 0 0 0 0 0 0 0 0 0 0 0 3 3 0 3 0 0 3 0 0 0 0 0 0 0 0 1 
1 0 4 0 0 0 0 0 3 0 0 0 0 0 0 0 0 3 3 4 0 0 0 0 0 0 0 3 0 0 3 0 7 0 0 0 0 4 0 1 
1 0 3 0 0 4 0 0 3 0 0 0 0 0 0 0 0 3 0 3 7 0 0 7 0 0 0 0 3 0 0 0 3 0 0 7 0 3 0 1 
1 0 7 3 0 0 0 0 0 0 0 0 0 0 0 0 0 0 3 3 3 0 0 3 0 0 0 0 0 0 0 0 7 0 0 0 0 0 3 1 
1 0 0 0 0 0 0 0 0 0 1 1 1 1 1 1 1 1 1 1 1 1 1 1 1 1 1 1 1 1 1 1 1 1 1 1 1 1 1 1 
1 4 4 0 0 0 0 0 0 0 0 0 4 0 0 0 7 0 0 0 0 3 0 0 0 0 0 3 0 0 0 3 0 0 0 0 0 0 0 1 
1 3 4 0 0 0 0 0 0 0 0 0 3 3 0 0 3 0 0 0 0 0 0 0 0 3 0 0 0 0 0 0 3 0 3 4 0 0 0 1 
1 0 3 0 0 3 0 0 0 0 0 0 0 0 3 0 0 0 0 0 3 0 4 4 0 0 0 0 7 0 0 0 3 0 3 3 0 0 0 1 
1 0 0 0 0 3 7 0 0 4 0 0 0 0 0 0 0 0 3 0 0 0 0 0 0 3 0 3 7 0 0 0 0 0 0 3 0 0 0 1 
1 0 0 0 4 0 0 4 0 3 0 0 3 0 3 3 0 0 0 0 0 0 0 0 0 3 0 3 7 0 0 0 0 0 0 3 0 0 3 1 
1 0 7 0 0 0 0 3 0 0 0 0 0 4 0 0 0 0 0 0 0 0 0 4 0 3 0 0 3 0 0 0 0 3 0 0 0 3 0 1 
1 1 1 1 1 1 1 1 1 1 1 1 1 1 1 1 1 1 1 1 1 1 1 1 1 1 1 1 1 1 1 1 1 1 1 1 1 1 1 1 