1111111111111111111111111111111111111111
1000000400703400000303000000040000300001
1038300000040000000003700300004000000001
1000000000040040000030300300000000300001
1304400000000030000003003000030003000001
1303300000000033003000000003000000303401
1000300300000000300000304300000000303301
1222222222222222222222222222222000300301
1040003007040030300000000007034000000301
1007000003000004000000003443007000030001
1000300303000000000000003303003000000001
1040000030000000033400000003003070000401
1030040030000000030370070000300030070301
1073000000000000003330030000000070000031
1000000000222222222222222222222222222221
1440000000004000700003000003000300000001
1340000000003300300000000300000030340091
1030030000000030000030440000700030330001
1000037004000000003000000303700000030001
1000400403003033000000000303700000030031
1070000300000400000000040300300003000301
1111111111111111111111111111111111111111