1111111111111111111111111111111111111111
1030030020300070200040302400000020033001
1000000020000000200040002400040020000401
1444444444444443433444444344744444444341
1700000020300003203040002003007020030301
1000000020300003203040002000003020004001
1222222222222222222242222222222222222221
1000033020040000200040032000040020000041
1000000020040000200040002000030420000031
1444444444434444444444444444434444444431
1300300020000300200340002000000724000001
1300003020030030200040442000000023000301
1030000020003000200040332000000023300301
1222222222222222222242222222222222222221
1304340020000303200040002037003020000001
1000004024000000200440002000400020404401
1444444443444444444744444444344444343341
1700003023000030203040032030300020000001
1000003023007000200044002003000020004441
1070003420040000208733002040000020003331
1030000320030030209030002000030320000301
1111111111111111111111111111111111111111