40 22
1216 160
1 1 1 1 1 1 1 1 1 1 1 1 1 1 1 1 1 1 1 1 1 1 1 1 1 1 1 1 1 1 1 1 1 1 1 1 1 1 1 1
1 0 3 0 0 3 0 0 1 0 3 0 0 0 7 0 1 0 0 0 1 0 3 7 1 1 0 0 0 0 0 0 1 0 0 3 3 0 0 1
1 0 0 0 0 0 0 0 1 0 0 0 0 0 0 0 1 0 0 0 1 0 0 0 1 1 0 0 0 1 0 0 0 0 0 0 0 1 7 1
1 1 1 4 1 1 1 1 1 1 1 1 1 1 1 3 1 3 3 1 1 1 0 1 1 3 1 1 7 1 1 1 1 1 1 1 1 3 1 1 
1 7 0 0 0 0 0 0 1 0 3 0 0 0 0 3 0 0 3 0 0 0 0 0 0 0 0 3 0 0 7 0 0 0 0 3 7 3 0 1 
1 0 0 0 0 0 0 0 1 0 3 0 0 0 0 0 4 0 3 0 1 0 0 0 1 0 0 0 0 0 3 0 1 0 0 0 1 0 0 1
1 1 1 4 1 1 1 1 1 1 1 1 4 1 1 0 1 1 1 1 1 1 0 1 1 1 1 1 1 1 1 1 1 1 1 1 1 1 1 1
1 0 0 0 0 3 3 0 1 0 0 1 0 0 0 0 1 0 0 0 1 0 0 3 1 7 0 0 0 1 0 0 1 7 0 0 0 0 1 1
1 0 0 0 0 0 0 0 4 0 0 4 0 0 0 0 1 0 0 0 0 0 0 0 1 0 0 0 0 3 0 1 1 0 0 0 0 0 3 1
1 1 1 1 1 1 1 1 1 1 1 3 1 1 1 1 1 1 0 1 1 1 1 1 1 1 1 1 1 3 1 1 1 1 1 1 1 1 3 1
1 3 0 0 3 0 0 0 1 0 0 0 0 3 0 0 1 0 0 3 1 0 0 0 0 0 0 0 0 0 0 7 1 1 0 0 0 0 0 1
1 3 0 0 0 0 3 0 4 0 0 3 0 0 3 0 1 0 0 0 1 0 1 1 1 0 0 0 0 0 0 0 4 3 0 0 0 3 0 1
1 0 3 0 0 0 0 0 1 0 0 0 3 0 0 0 1 0 0 0 0 0 3 3 1 0 0 0 0 0 0 0 1 3 3 0 0 0 0 1
1 1 0 0 1 1 1 1 1 1 1 1 1 1 4 4 1 1 1 1 1 1 1 1 1 1 1 1 1 1 1 1 1 1 1 1 4 1 1 1
1 3 0 4 3 4 0 0 1 0 0 0 0 3 0 3 1 7 0 0 1 3 0 0 4 0 3 7 0 0 3 0 1 0 0 0 0 0 0 1
1 0 0 0 0 0 4 0 1 4 0 0 0 0 0 0 1 0 0 4 1 0 0 0 1 0 0 0 4 0 0 0 1 0 4 0 4 4 0 1
1 1 1 1 1 1 4 4 1 3 1 1 1 1 1 1 1 1 1 7 1 4 1 1 1 1 1 0 3 1 1 1 1 1 3 1 3 3 1 1
1 7 0 0 0 0 3 0 1 3 0 0 0 0 3 0 1 0 3 0 1 0 0 3 1 0 3 0 3 0 0 0 1 0 0 0 0 0 0 1
1 0 4 4 4 4 3 0 1 3 0 0 7 0 0 0 1 0 0 0 1 1 0 0 1 0 0 3 0 0 0 0 4 0 0 0 1 1 1 1
1 0 7 4 4 4 3 4 1 0 0 1 0 0 0 0 1 0 8 7 3 3 0 0 1 0 1 0 0 0 0 0 1 0 0 0 3 3 3 1
1 0 3 4 4 4 0 3 1 0 0 3 0 0 3 0 1 0 9 0 3 0 0 0 1 0 0 0 0 3 0 3 1 0 0 0 0 3 0 1
1 1 1 1 1 1 1 1 1 1 1 1 1 1 1 1 1 1 1 1 1 1 1 1 1 1 1 1 1 1 1 1 1 1 1 1 1 1 1 1 