1 1 1 1 1 1 1 1 1 1 1 1 1 1 1 1 1 1 1 1 1 1 1 1 1 1 1 1 1 1 1 1 1 1 1 1 1 1 1 1 
1 0 3 0 0 3 0 0 2 0 3 0 0 0 7 0 2 0 0 0 4 0 3 0 2 4 0 0 0 0 0 0 2 0 0 3 3 0 0 1 
1 0 0 0 0 0 0 0 2 0 0 0 0 0 0 0 2 0 0 0 4 0 0 0 2 4 0 0 0 4 0 0 2 0 0 0 0 4 0 1 
1 4 4 4 4 4 4 4 4 4 4 4 4 4 4 3 4 3 3 4 4 4 4 4 4 3 4 4 7 4 4 4 4 4 4 4 4 3 4 1 
1 7 0 0 0 0 0 0 2 0 3 0 0 0 0 3 2 0 3 0 4 0 0 0 2 0 0 3 0 0 7 0 2 0 0 3 0 3 0 1 
1 0 0 0 0 0 0 0 2 0 3 0 0 0 0 3 2 0 3 0 4 0 0 0 2 0 0 0 0 0 3 0 2 0 0 0 4 0 0 1 
1 2 2 2 2 2 2 2 2 2 2 2 2 2 2 2 2 2 2 2 4 2 2 2 2 2 2 2 2 2 2 2 2 2 2 2 2 2 2 1 
1 0 0 0 0 3 3 0 2 0 0 4 0 0 0 0 2 0 0 0 4 0 0 3 2 0 0 0 0 4 0 0 2 0 0 0 0 0 4 1 
1 0 0 0 0 0 0 0 2 0 0 4 0 0 0 0 2 0 0 0 4 0 0 0 2 0 0 0 0 3 0 4 2 0 0 0 0 0 3 1 
1 4 4 4 4 4 4 4 4 4 4 3 4 4 4 4 4 4 4 4 4 4 4 4 4 4 4 4 4 3 4 4 4 4 4 4 4 4 3 1 
1 3 0 0 3 0 0 0 2 0 0 0 0 3 0 0 2 0 0 3 4 0 0 0 2 0 0 0 0 0 0 7 2 4 0 0 0 0 0 1 
1 3 0 0 0 0 3 0 2 0 0 3 0 0 3 0 2 0 0 0 4 0 4 4 2 0 0 0 0 0 0 0 2 3 0 0 0 3 0 1 
1 0 3 0 0 0 0 0 2 0 0 0 3 0 0 0 2 0 0 0 4 0 3 3 2 0 0 0 0 0 0 0 2 3 3 0 0 3 0 1 
1 2 2 2 2 2 2 2 2 2 2 2 2 2 2 2 2 2 2 2 4 2 2 2 2 2 2 2 2 2 2 2 2 2 2 2 2 2 2 1 
1 3 0 4 3 4 0 0 2 0 0 0 0 3 0 3 2 0 0 0 4 0 0 0 2 0 3 7 0 0 3 0 2 0 0 0 0 0 0 1 
1 0 0 0 0 0 4 0 2 4 0 0 0 0 0 0 2 0 0 4 4 0 0 0 2 0 0 0 4 0 0 0 2 0 4 0 4 4 0 1 
1 4 4 4 4 4 4 4 4 3 4 4 4 4 4 4 4 4 4 7 4 4 4 4 4 4 4 4 3 4 4 4 4 4 3 4 3 3 4 1 
1 7 0 0 0 0 3 0 2 3 0 0 0 0 3 0 2 0 3 0 4 0 0 3 2 0 3 0 3 0 0 0 2 0 0 0 0 0 0 1 
1 0 0 0 0 0 3 0 2 3 0 0 7 0 0 0 2 0 0 0 4 4 0 0 2 0 0 3 0 0 0 0 2 0 0 0 4 4 4 1 
1 0 7 0 0 0 3 4 2 0 0 4 0 0 0 0 2 0 8 7 3 3 0 0 2 0 4 0 0 0 0 0 2 0 0 0 3 3 3 1 
1 0 3 0 0 0 0 3 2 0 0 3 0 0 3 0 2 0 9 0 3 0 0 0 2 0 0 0 0 3 0 3 2 0 0 0 0 3 0 1 
1 1 1 1 1 1 1 1 1 1 1 1 1 1 1 1 1 1 1 1 1 1 1 1 1 1 1 1 1 1 1 1 1 1 1 1 1 1 1 1 
