1 1 1 1 1 1 1 1 1 1 1 1 1 1 1 1 1 1 1 1 1 1 1 1 1 1 1 1 1 1 1 1 1 1 1 1 1 1 1 1 
1 7 7 7 3 3 7 7 3 7 7 3 4 3 3 3 3 7 3 7 7 4 7 7 3 7 7 3 7 7 7 7 3 3 7 3 7 3 3 1 
1 7 3 3 7 7 7 3 3 3 7 3 7 7 3 3 3 3 3 3 7 3 3 7 4 7 3 7 3 3 3 3 7 3 7 7 3 3 7 1 
1 7 7 3 3 3 3 3 3 3 7 3 7 7 3 3 4 3 3 3 7 3 3 7 7 7 3 7 3 4 3 3 7 3 3 3 7 7 3 1 
1 3 3 7 3 7 7 3 3 3 3 3 3 7 3 3 7 7 7 4 4 7 7 3 3 7 3 7 7 3 3 7 3 7 7 4 3 3 7 1 
1 3 3 7 3 7 7 3 3 3 3 3 3 7 3 3 7 4 7 3 7 3 3 3 3 7 3 7 3 7 3 3 7 7 3 3 7 3 7 1 
1 7 7 7 3 3 7 3 7 4 7 7 3 3 7 7 3 3 7 7 7 3 3 7 3 7 3 3 3 4 3 3 7 7 3 3 7 3 7 1 
1 3 3 3 3 3 7 3 3 7 7 7 7 4 4 3 3 3 7 3 7 7 4 3 7 3 7 7 3 4 3 3 7 7 7 7 7 7 3 1 
1 7 3 7 7 2 2 2 2 2 2 2 4 2 2 2 2 2 7 3 3 3 3 7 3 2 2 2 2 2 2 4 2 2 2 2 2 2 3 1 
1 7 4 7 7 2 4 4 4 4 4 4 4 4 4 4 4 2 3 7 7 3 3 3 7 2 4 4 4 4 4 4 4 4 4 4 4 2 3 1 
1 7 3 7 3 2 4 8 9 4 4 4 4 4 4 4 4 2 3 7 7 3 3 3 7 2 4 4 4 4 4 4 4 4 4 4 4 2 3 1 
1 7 3 3 7 2 4 4 4 4 4 4 4 4 4 4 4 2 3 4 3 3 7 7 3 2 4 4 4 4 4 4 4 4 4 4 4 2 3 1 
1 7 3 3 7 2 4 4 4 4 4 4 4 4 4 4 4 2 7 7 7 7 3 7 3 2 4 4 4 4 4 4 4 4 4 4 4 2 7 1 
1 3 7 7 7 2 4 4 4 4 4 4 4 4 4 4 4 2 7 3 3 7 4 7 3 2 4 4 4 4 4 4 4 4 4 4 4 2 7 1 
1 3 3 3 3 2 4 4 4 4 4 4 4 4 4 4 4 2 7 3 3 7 7 3 3 2 4 4 4 4 4 4 4 4 4 4 4 2 3 1 
1 7 3 7 7 2 4 4 4 4 4 4 4 4 4 4 4 2 4 3 7 3 3 7 3 2 4 4 4 4 4 4 4 4 4 4 4 2 3 1 
1 7 3 7 7 2 4 4 4 4 4 4 4 4 4 4 4 2 2 2 2 2 2 2 2 2 4 4 4 4 4 4 4 4 4 4 4 2 3 1 
1 3 3 3 7 2 4 4 4 4 4 4 4 4 4 4 4 4 4 4 4 4 4 4 4 4 4 4 4 4 4 4 4 4 4 4 4 2 3 1 
1 3 3 3 7 2 4 4 4 4 4 4 4 4 4 4 4 2 7 7 4 3 7 3 7 2 4 4 4 4 4 4 4 4 4 4 4 2 3 1 
1 7 7 3 3 2 4 4 4 4 4 4 4 4 4 4 4 2 3 3 3 7 3 7 7 2 4 4 4 4 4 4 4 4 4 4 4 2 3 1 
1 7 7 4 4 2 2 2 2 2 2 2 2 2 2 2 2 2 7 3 3 3 7 7 7 2 2 2 2 2 2 2 2 2 2 2 2 2 7 1 
1 1 1 1 1 1 1 1 1 1 1 1 1 1 1 1 1 1 1 1 1 1 1 1 1 1 1 1 1 1 1 1 1 1 1 1 1 1 1 1 
