1111111111111111111111111111111111111111
1777337737734333373774773773777733737331
1733777333737733333373374737333373773371
1773333333737733433373377737343373337731
1337377333333733777447733737733737743371
1337377333333733747373333737373377337371
1777337374773377337773373733343377337371
1333337337777443337377437377343377777731
1737722222224222227333373222222422222231
1747724444444444423773337244444444444231
1737324894444444423773337244444444444231
1733724444444444423433773244444444444231
1733724444444444427777373244444444444271
1377724444444444427337473244444444444271
1333324444444444427337733244444444444231
1737724444444444424373373244444444444231
1737724444444444422222222244444444444231
1333724444444444444444444444444444444231
1333724444444444427743737244444444444231
1773324444444444423337377244444444444231
1774422222222222227333777222222222222271
1111111111111111111111111111111111111111