40 22
1100 500
1 1 1 1 1 1 1 1 1 1 1 1 1 1 1 1 1 1 1 1 1 1 1 1 1 1 1 1 1 1 1 1 1 1 1 1 1 1 1 1 
1 0 0 0 0 3 0 0 3 0 0 3 4 3 0 7 0 0 3 0 0 4 0 0 3 0 0 3 0 0 0 0 3 3 0 3 0 3 3 1 
1 0 0 3 0 0 0 3 3 3 0 3 0 0 0 0 0 3 0 3 0 3 0 0 4 0 0 0 3 0 0 0 0 3 0 0 0 3 0 1 
1 0 0 0 0 0 0 3 3 3 0 3 0 0 3 3 4 0 0 3 0 3 0 0 0 0 3 0 3 4 3 3 0 0 0 7 0 0 3 1 
1 3 3 0 3 0 0 0 3 3 3 3 0 0 3 0 4 0 0 0 4 0 0 3 3 0 0 0 0 3 3 0 3 0 0 4 3 3 0 1 
1 3 0 7 3 0 0 0 0 0 0 0 0 0 3 0 0 4 0 3 0 0 0 0 3 0 0 0 0 0 0 3 0 0 3 3 0 3 0 1 
1 0 0 0 3 3 0 3 0 4 0 0 0 3 0 0 3 3 0 0 0 3 3 0 3 0 3 3 0 4 3 3 0 0 3 3 0 3 0 1 
1 3 0 0 3 3 0 3 3 0 0 0 0 4 4 3 3 3 0 3 0 0 4 3 0 3 0 0 3 4 3 3 0 0 0 0 0 0 3 1 
1 0 3 0 0 1 1 1 1 1 1 1 4 1 1 1 1 1 0 3 3 3 3 0 3 1 1 1 1 1 1 4 1 1 1 1 1 1 3 1 
1 0 4 0 0 1 7 4 4 4 4 4 4 4 4 4 4 1 3 0 0 0 3 3 0 1 4 4 4 4 4 4 4 4 4 4 4 1 3 1 
1 0 0 0 3 1 4 11 0 4 4 4 4 4 4 4 4 1 3 0 0 0 3 3 0 1 4 4 4 4 4 4 4 4 4 4 4 1 3 1 
1 0 0 3 0 1 4 4 4 4 4 4 4 4 4 4 4 1 3 4 0 0 0 0 3 1 4 4 4 4 10 4 4 4 4 4 4 1 3 1 
1 0 0 3 0 1 4 4 4 4 4 4 4 4 4 4 4 1 0 0 0 0 3 0 3 1 4 4 4 4 4 4 4 4 4 4 4 1 0 1 
1 3 0 0 0 1 4 4 4 4 4 4 4 4 4 4 4 1 0 3 0 0 4 0 3 1 4 4 4 4 4 4 4 4 4 4 4 1 0 1 
1 3 0 0 3 1 4 4 4 4 4 4 4 4 4 4 4 1 0 3 3 7 0 3 3 1 4 4 4 4 5 4 4 4 4 4 4 1 3 1 
1 0 3 0 0 1 4 4 4 4 4 4 4 4 4 4 4 1 4 3 0 3 3 0 3 1 4 4 4 4 4 4 4 4 4 4 4 1 3 1 
1 0 0 0 0 1 4 4 4 4 4 4 4 4 4 4 4 1 1 1 1 1 1 1 1 1 4 4 4 4 4 4 4 4 4 4 4 1 3 1 
1 0 0 3 0 1 4 4 4 4 4 4 4 4 4 4 4 4 4 4 4 4 4 4 4 4 4 4 4 4 4 4 4 4 4 4 4 1 3 1 
1 0 3 3 0 1 4 4 4 4 4 4 4 4 4 4 4 1 0 0 4 3 0 3 0 1 4 4 4 4 4 4 4 4 4 4 4 1 3 1 
1 0 0 3 0 1 4 4 4 4 4 4 7 4 4 6 4 1 3 3 3 0 3 0 0 1 4 4 4 4 4 4 7 4 4 4 4 1 3 1 
1 7 0 0 4 1 1 1 1 1 1 1 1 1 1 1 1 1 0 3 3 3 0 7 0 1 1 1 1 1 1 1 1 1 1 1 1 1 0 1 
1 1 1 1 1 1 1 1 1 1 1 1 1 1 1 1 1 1 1 1 1 1 1 1 1 1 1 1 1 1 1 1 1 1 1 1 1 1 1 1 
