1111111111111111111111111111111111111111
1000000000002222222222222222222222222901
1000000002222222222222222222222222222801
1000000002222222222222222222222222222201
1000000002222222222222222222222222222201
1000000002222222222222222222222222222201
1000000000000000000000000000022222222201
1000000000000000000000000000022222222201
1777777700000000000000000000022222222201
1777777700000000000000000000022222222201
1777777700000000000000000000022222222201
1777777700000000000000000000002222222201
1777777700000000000000000000002222222201
1777777700000000000000000000002222222201
1777777700000000000000000000002222222201
1777777700000000000000000000000000000001
1777777700000000000000077777777000000001
1777777707777777777777777777777000000001
1777777707777777777777777777777000000001
1000000007777777777777777777777000000001
1000000000000000000000000000000000000001
1111111111111111111111111111111111111111