40 22
865 224
1 1 1 1 1 1 1 1 1 1 1 1 1 1 1 1 1 1 1 1 1 1 1 1 1 1 1 1 1 1 1 1 1 1 1 1 1 1 1 1 
1 3 0 1 1 0 1 3 3 0 1 0 0 0 3 1 3 0 0 3 0 0 0 0 1 0 0 0 3 0 0 0 0 0 3 1 0 7 0 1 
1 0 0 8 1 0 4 0 3 0 0 0 0 0 1 1 1 0 0 1 0 3 0 0 0 0 3 0 0 3 0 3 0 0 0 1 0 1 3 1 
1 0 0 0 0 1 0 0 3 4 0 0 3 0 0 0 0 1 0 0 0 0 0 3 0 1 1 3 0 0 0 0 0 0 0 1 0 1 1 1 
1 7 0 1 0 10 1 3 1 3 0 0 3 0 0 0 0 1 0 0 0 3 0 0 0 0 0 0 3 0 3 3 0 0 0 0 0 0 1 1 
1 3 0 1 0 0 0 1 0 0 3 0 1 1 0 0 3 0 1 1 7 0 5 0 0 4 4 4 3 0 3 3 0 0 0 0 0 0 1 1 
1 3 3 0 0 3 0 0 0 0 1 0 0 0 3 0 0 0 0 0 0 3 0 3 3 4 4 4 0 0 0 3 0 0 4 1 1 0 0 1 
1 0 0 3 0 1 1 0 0 3 0 3 3 0 0 0 1 0 0 0 0 3 0 3 3 4 4 4 0 0 0 1 0 0 0 0 1 0 3 1 
1 0 0 1 0 0 0 7 0 0 0 0 0 0 4 0 3 0 0 1 1 3 0 0 3 0 1 0 1 3 0 0 1 3 0 0 7 0 3 1 
1 3 0 3 0 0 0 0 1 0 1 1 0 11 4 0 3 0 0 1 1 3 0 0 3 0 0 0 0 1 0 0 0 1 0 0 3 0 1 1 
1 0 3 0 1 1 0 0 0 0 0 3 3 1 3 0 0 4 0 1 0 1 3 0 0 1 3 0 0 0 1 3 0 0 4 0 3 0 0 1 
1 1 0 1 1 0 0 0 0 0 0 3 3 1 3 0 0 3 0 1 0 1 1 0 0 0 1 0 0 3 0 1 1 0 0 3 0 0 0 1 
1 0 1 0 3 0 0 0 1 0 0 0 1 1 3 0 0 3 0 0 0 0 1 0 0 0 3 0 0 0 0 0 1 1 0 3 0 0 0 1 
1 0 1 0 3 0 0 0 1 0 4 0 1 0 1 3 0 0 1 3 0 0 0 0 3 0 0 3 0 3 3 0 0 0 0 1 0 0 0 1 
1 1 0 0 1 3 1 3 0 0 3 0 0 0 0 1 0 0 0 7 0 0 0 1 0 3 1 0 0 0 0 0 0 1 0 1 1 0 7 1 
1 1 0 0 0 1 1 3 0 0 1 0 0 0 0 0 1 3 0 0 3 0 3 0 0 0 3 0 1 3 0 0 0 0 0 0 1 0 0 1 
1 1 0 7 0 0 6 0 3 0 1 1 0 0 0 0 1 1 3 0 0 0 0 0 0 0 3 0 1 3 0 0 0 0 0 0 1 0 0 1 
1 0 0 3 0 0 0 0 1 0 0 0 3 0 0 0 0 0 0 3 0 3 3 0 0 0 0 0 0 1 0 0 3 0 1 0 0 0 1 1 
1 3 0 1 1 0 0 3 0 1 1 0 0 0 1 0 0 0 0 3 0 3 3 0 0 0 0 0 0 1 0 0 3 4 0 0 3 0 9 1 
1 1 0 0 0 3 0 0 0 0 0 0 3 0 3 4 0 0 0 0 0 0 3 0 0 0 1 1 0 0 1 3 0 0 4 0 1 0 0 1 
1 3 3 0 0 0 1 0 0 0 0 0 3 0 3 7 0 0 0 0 0 0 1 0 0 3 0 1 7 0 4 0 3 1 0 3 0 0 0 1 
1 1 1 1 1 1 1 1 1 1 1 1 1 1 1 1 1 1 1 1 1 1 1 1 1 1 1 1 1 1 1 1 1 1 1 1 1 1 1 1 
