1 1 1 1 1 1 1 1 1 1 1 1 1 1 1 1 1 1 1 1 1 1 1 1 1 1 1 1 1 1 1 1 1 1 1 1 1 1 1 1 
1 3 0 2 2 0 2 3 3 0 2 0 0 0 3 2 3 0 0 3 0 0 0 0 2 0 0 0 3 0 0 0 0 0 3 2 0 7 0 1 
1 0 0 8 2 0 7 0 3 0 0 0 0 0 2 2 2 0 0 2 0 3 0 0 0 0 3 0 0 3 0 3 0 0 0 2 0 2 3 1 
1 0 0 0 0 2 0 0 3 7 0 0 3 0 0 0 0 2 0 0 0 0 0 3 0 2 2 3 0 0 0 0 0 0 0 2 0 2 2 1 
1 7 0 2 0 0 2 3 2 3 0 0 3 0 0 0 0 2 0 0 0 3 0 0 0 0 0 0 3 0 3 3 0 0 0 0 0 0 2 1 
1 3 0 2 0 0 0 2 0 0 3 0 2 2 0 0 3 0 2 2 7 0 0 0 0 0 0 0 3 0 3 3 0 0 0 0 0 0 2 1 
1 3 3 0 0 3 0 0 0 0 2 0 0 0 3 0 0 0 0 0 0 3 0 3 3 0 0 0 0 0 0 3 0 0 7 2 2 0 0 1 
1 0 0 3 0 2 2 0 0 3 0 3 3 0 0 0 2 0 0 0 0 3 0 3 3 0 0 0 0 0 0 2 0 0 0 0 2 0 3 1 
1 0 0 2 0 0 0 7 0 0 0 0 0 0 7 0 3 0 0 2 2 3 0 0 3 0 2 0 2 3 0 0 2 3 0 0 7 0 3 1 
1 3 0 3 0 0 0 0 2 0 2 2 0 0 7 0 3 0 0 2 2 3 0 0 3 0 0 7 0 2 0 0 0 2 0 0 3 0 2 1 
1 0 3 0 2 2 0 0 0 0 0 3 3 2 3 0 0 7 0 2 0 2 3 0 0 2 3 0 0 0 2 3 0 0 7 0 3 0 0 1 
1 2 0 2 2 0 0 0 0 0 0 3 3 2 3 0 0 3 0 2 0 2 2 0 0 0 2 0 0 3 0 2 2 0 0 3 0 0 0 1 
1 0 2 0 3 0 0 0 2 0 0 0 2 2 3 0 0 3 0 0 0 0 2 0 0 0 3 0 0 0 0 0 2 2 0 3 0 0 0 1 
1 0 2 0 3 0 0 0 2 0 7 0 2 0 2 3 0 0 2 3 0 0 0 0 3 0 0 3 0 3 3 0 0 0 0 2 0 0 0 1 
1 2 0 0 2 3 2 3 0 0 3 0 0 0 0 2 0 0 0 7 0 0 0 2 0 3 2 0 0 0 0 0 0 2 0 2 2 0 7 1 
1 2 0 0 0 2 2 3 0 0 2 0 7 0 0 0 2 3 0 0 3 0 3 0 0 0 3 0 2 3 0 0 0 0 0 0 2 0 0 1 
1 2 0 7 0 0 0 0 3 0 2 2 0 0 0 0 2 2 3 0 0 0 0 0 0 0 3 0 2 3 0 0 0 0 0 0 2 0 0 1 
1 0 0 3 0 0 0 0 2 0 0 0 3 0 0 0 0 0 0 3 0 3 3 0 0 0 0 0 0 2 0 0 3 0 2 0 0 0 2 1 
1 3 0 2 2 0 0 3 0 2 2 0 0 0 2 0 0 0 0 3 0 3 3 0 0 0 0 0 0 2 0 0 3 7 0 0 3 0 9 1 
1 2 0 0 0 3 0 0 0 0 0 0 3 0 3 7 0 0 0 0 0 0 3 0 0 0 2 2 0 0 2 3 0 0 7 0 2 0 0 1 
1 3 3 0 0 0 2 0 0 0 0 0 3 0 3 7 0 0 0 0 0 0 2 0 0 3 0 2 7 0 7 0 3 2 0 3 0 0 0 1 
1 1 1 1 1 1 1 1 1 1 1 1 1 1 1 1 1 1 1 1 1 1 1 1 1 1 1 1 1 1 1 1 1 1 1 1 1 1 1 1 
