1111111111111111111111111111111111111111
1302202330200032300300002000300000320701
1008207030000022200203000030030300020231
1000020037003000020000030223000000020221
1702002323003000020003000000303300000021
1302000200302200302270000000303300000021
1330030000200030000003033000000300722001
1003022003033000200003033000000200002031
1002000700000070300223003020230023007031
1303000020220070300223003007020002003021
1030220000033230070202300230002300703001
1202200000033230030202200020030220030001
1020300020002230030000200030000022030001
1020300020702023002300003003033000020001
1200232300300002000700020320000002022071
1200022300207000230030300030230000002001
1207000030220000223000000030230000002001
1003000020003000000303300000020030200021
1302200302200020000303300000020037003091
1200030000003037000000300022002300702001
1330002000003037000000200302707032030001
1111111111111111111111111111111111111111